{
  name: "My Level",
  level: `
........................................
........................................
........................................
........................................
.....^........................#.........
...###^...^^....#^^#^^#.....^...^....|..
`,
},